Year,Treatment success,Treatment failed,Dead,LTFU,Not Evaluated,Total
2010,390,82,101,216,2,791
2011,413,72,100,176,0,761
2012,504,87,91,171,3,856
2013,538,93,112,194,6,943
2014,457,142,129,188,3,919
2015,487,177,120,202,10,996
2016,518,132,125,198,6,979
2017,537,124,117,183,1,962
2018,541,111,98,169,2,921
2019,387,35,76,13,48,559